1121112111
1        2
11  12   1
1   11   1
1        1
11112    1
1111111121