1111112111
1        2
11  12   1
1   11   1
1       21
11112    1
1       11
2  1   211
1  1     1
1211111211